숲길=숲 속에 나 있는 길
재등록=이미 등록하였던 것을 다시 등록함
산록=‘산기슭’으로 순화
재편=‘재편성’과 같은 말
서편=서쪽 편
조종사=파일럿이라고도 하며 항공업무 종사자중 직접 항공기를 조종하는 사람은
서랍장=여러개의 서랍으로 구성되어 있는 장은
대추차=잘 말린 대추를 달여 물엿처럼 만들어 놓고 뜨거운 물에 타 마시는 차는
보따리=보자기 뭉치를 의미하는 단어이며 이야기 xxx를 푼다고 말할 때 쓰기도 하죠
조각상=재료를 새기거나 깍아서 만든 입체 형상은
소몰이=소를 몰고 다니는 일. 또는 그런 사람은
트렌치코트=가을하면 생각나는 코트 옷깃에서 소매까지 통째로 이어진 형태로, 전체적으로 품이 넉넉한 외투
사직서=사표와 동의어로 직책에서 사임하겠다는 뜻을 적어 내는 문서는
대타=어떤 일을 원래하던 사람을 대신하여 하는 사람을 비유적으로 이르는 말
장윤정=어머나, 올레 등을 부른 트로트가수의 이름은
차단기=전류를 차단하기위해쓰는 기구이기도하며 정문 따위에서 자동차나 사람을 점검하기 위해 정지하도록 막는 장치
보건소=국민보건의 향상을 도모하기 위하여 전국의 시. 군. 구 단위에 설치된 보건행정기관
이벤트=남자친구가 여자친구에게 기념일에 xxx를 해주곤 하죠
상아색=맑고 연한 흰노랑. 코끼리 상아의 색을 띄는 색의 이름은
세탁소=돈을 받고 세탁일을 전문적으로 하는 곳은
신용카드=크레디카드라고도 하며 이 카드를 제시하고 전표에 서명을 하면 현금의 지츨 없이 구매가 가능하다
이유식=젖을 뗀 아기가 먹는 삼키기 쉬운 음식은
도박=노름이라고도 하며 금품을 걸고 승부를 다투는 일을 무엇이라고 할까
원근감=멀고 가까운 거리에 대한 느낌을 무엇이라 할까
사비=개인이 부담하고 지출하는 비용을 이르는 말은
각선미=여자의 다리가 예쁠 때 xxx가 예쁘다고 하죠
세제곱=같은 수를 세 번 곱하는 일. 또는 그렇게 하여 얻어진 수는
소신=굳게 믿고 있는 바. 또는 생각하는 바를 의미하는 단어
카네이션=어버이날에 부모님 가슴에 달아 드리는 꽃은
식물원=식물에 관한 지식 보급을 위해 여러 식물들을 모아서 기르는 곳은
소속감=소속되어 있는 느낌을 무엇이라고 할까
박하사탕=박하향이 나는 하얀 사탕은
선장=배 안에서 모든 일에 대한 책임을 지고 있고 배에서 대장이라고 할 수 있는 사람은
계절=규칙적으로 되풀이되는 자연현상에 따라서 일 년을 구분한 것
빙의=일반적으로 귀신들림, 귀신에 씌움을 의미하는 것으로 몸에 다른 영이 들어온 것을 말한다
체르노빌=우크라이나의 도시. 1986년 이곳의 원자력 발전소에서 불이 나면서 사상 최악의 원전사고가 있었다
미인박명=용모가 아름다운 여자는 대개 불행하거나 병약하여 일찍 죽는 일이 많다는 뜻의 사자성어
트리=크리스마스 때의 여러가지 장식으로 꾸미는 나무를 크리스마스 xx라 하죠
행인=길을 가는 사람
고액권=큰 액수의 지폐
경고=조심하거나 삼가도록 미리 주의를 줌
의뢰인=남에게 어떤일을 맡긴 사람
절체절명=몸과 목숨이 끊어질 지경이란 뜻으로 아무리 하여도 어쩔 수 없는 궁박한 경우를 이르는 말
농노=중세 봉건사회에서 , 봉건 영주에게 예속된 농민
빌트인=건물 내에 필요한 전자 제품등을 가구나 벽 등에 집어넣어 보이지 않게 하는 방법
미니마우스=미키마우스의 여자친구
고고학자=유물과 유적을 통하여 옛 인류의 생활, 문화 따위를 연구하는 학자
행정권=국가가 통치권을 바탕으로 일반행정을 펴는 권능. 입법권, 사법권, xxx
사막여우=사막에서 사는 귀가 큰 여우는
주피터=로마신화에 나오는 최고의 신은
상류사회=신분이나 생활 수준이 높은 사람들의 사회를 무엇이라 하는가
자반=콩에 간장 설탕을 넣어 조린 음식을 콩xx이라 하지요
흉악범=아주 흉악한 죄를 지은 사람을 무엇이라 하는가
펜팔=예전에 군인 아저씨와 여고생 사이에 얼굴은 모르지만 편지를 주고 받으며 연락을 취하던 일
리액션=방송프로에서 관중이나 케스트가 보이는 반응을 무엇이라 하는가
사법연수원=사법 시험에 합격한 사람들을 교육하는 기관은
여우주연상=영화제 시상식에서 여배우에게 주어지는 가장 큰 상은
공터=아무 것도 없는 텅 빈 땅은
흉기=사람을 죽이거나 해치는 데 쓰는 도구
류승범=감독 류승완의 동생으로도 잘 알려진 개성파 배우의 이름은
회자정리=만나면 헤어지는 것은 거스를 수 없는 이치라는 뜻이죠
액정=핸드폰 xx이 깨지면 수리비가 많이 나오지요
펜션=가정적 분위기의 숙소에 편의성을 갖춘 숙박시설은
사팔=눈동자가 사시인 사람을 xx뜨기라 부른다
