수학익힘책=수학책을 난로위에 올리면?
교도소=도둑이 없는 도둑마을은 어딘가?
야금야금=금은 금인데 도둑고양이에게 가장 어울리는 금은?
이별=별 중에 가장 슬픈 별은?
홍길동전=붉은 길에 동전 하나가 떨어져 있다. 그 동전의 이름은?
요강=가장 더러운 강은?
거짓말=말은 말인데 타지 못하는 말은?
수제비=사람이 먹을 수 있는 제비는?
멕시코=세상에서 제일 큰 코는?
후다닥=세상에서 가장 빠른 닭은?
무지개=개 중에 가장 아름다운 개는?
커피=사람이 즐겨 먹는 피는?
당기소=미소의 반댓말은?
거지=사업상 목욕을 할 수 없는 사람은?
바나나킥=바나나가 웃으면?
오목=다섯 그루의 나무를 심으면?
포트리스=네 그루의 나무를 심으면?
별달기=하늘의 별따기 보다 더 여려운 것은?
불고기=물고기의 반대말은?
나이=편식이 아무리 심한 사람도 어쩔 수없이 먹는것은?
이글이글=독수리가 불에 타면 내는 소리는?
빙하시대=팽귄이 다니는 대학교는?
물로켓=물로 만든 고양이를 세글자로 하면?
언덕=오리가 꽁꽁얼면?
호랑=이 빠진 호랑이는?
한의사=손님이 뜸하면 돈 버는 사람은?
줄다리기=뒷걸음질 잘해야 이기는 경기는?
킹콩=왕이 넘어지면?
풋볼=공이 웃으면?
잉카=자동차가 울면?
딸기시럽=딸기가 회사에서 짤리면?
분당=바람이 귀엽게 부는 곳은?
커용=자가용의 반대말은?
탄소=소고기가 불에 타면?
쿵푸=곰돌이 푸우가 넘어지면?
할머니=할아버지가 제일 좋아하는 돈은?
카톡=자동차를 툭 치면?
안마사=등을 칠수록 돈을 버는 사람은?
피자=다리미가 좋아하는 음식은?
부탄=제일 폭발하기 쉬운 나라는?
우엉=뽑으면 우는 식물은?
미어캣=고양이를 싫어하는 동물은?
케냐=광부가 가장 많은 나라는?
흑인=사람이 울면?
칫솔=소나무가 삐지면?
양팡=우유가 아프면?
오세아니아=나는 5살이 아니야를 5글자로 하면?
부귀영화=사람들이 가장 좋아하는 영화는?
닥터피쉬=가장 공부를 열심히 한 물고기는?
판다=세상에서 가장 장사를 잘 하는 동물은?
만우절=만마리의 소들이 절을 하는 것을 세글자로 하면?
나물=마시지 않고 씹어먹는 물은?
백지영=매일 시험을 봐도 빵점만 맞는 연예인은?
궁시렁=왕이 궁에 들어가기 싫어하면?
누네띠네=도둑이 제일 싫어하는 과자는?
제대=군인이 제일 좋아하는 대학은?
쥐포=쥐 4마리가 모이면?
무선전화기=전화기 중에서 사람들이 무서워하는 전화기는?
형편없는세상=형과 동생이 싸웠는데 부모님이 형 편을 들어주지 않는 세상은?
신기록=깨뜨리고 칭찬받는 것은?
삐약=병아리가 열심히 찾는 약은?
배철수=어부들이 싫어하는 연예인은?
로딩중=한국 사람들이 가장 지루해하고 답답해하는 중학교는?
상봉역=헤어진 사람들이 만나는 지하철 역은?
심술=놀부가 가장 좋아하는 술은?
저녁=군인들이 좋아하는 시간은?
킥보드=보드가 웃으면 뭐라고 할까?
방학동=초등학생이 가장 좋아하는 동네는?
고려=결정 장애가 많은 나라는?
푸켓=곰돌이 푸와 고양이를 두글자로 ?
아이유=남자들이 열광하는 우유는?
산채비빔밥=세상에서 가장 잔인한 비빔밥은?
인사동=예의바른 사람들만 사는 동네는?
남아공=온 나라에 공이 넘치는 나라는?
형광펜=형을 너무 좋아하는 동생을 세글자로 하면?
치킨텐더=통닭 10마리 더 주세요! 를 네 글자로 하면?

