가가문전=집집의 문앞
가고=집안에 일어난 사고
가구물=여러 재료를 얽어 맞추어 만든 구조물
가꾸로=차례나 방향이 반대로 되게.
가동교=다리의 일부 또는 전부를 움직여서 아래로 배가 지나갈 수 있게 만든 다리
가리=물고기를 잡는 기구의 한 가지. 대나무를 결어 만든 것으로 통발과 비슷하나 밑이 없음
가리새=도자기를 만들 때 도자기 겉을 긁는 데 쓰는 꼬부라진 쇠 
가마호수=도자기를 빗는 가마에 불을 때는 사람
가무=신라시대에 피리에 맞추어 춤을 추며 노래하던 무악
가무퇴퇴=빛깔이 탁하게 가무스름하다
가보=민어의 부레 속에 소를 넣고 끝을 실로 잡아매어 삶아 익힌 다음 둥글게 썬 음식
가분=거짓으로 꾸며 분장함.
가사=아름다운 말
가손=자기 손자를 남에게 이르는 말
가수=죄인의 목에 칼을 씌워 옥에 가두던 일.
가시눈=날카롭게 쏘아보는 눈
가하=돈을 정한 액수보다 더 씀.
가행=한 집안의 품행
가화=좋은 이야기
각원=한 나라의 내각을 구성하는 각 장관. 각료.
각일각=시간이 지나감에 따라
간니=젖니가 빠진 다음에 나는 이. 영구치.
간대=후히 대접함
간명=마음속에 깊이 새김
간접비=몇 가지 종류의 제품에 공통으로 드는 비용.
갈도=지체 높은 사람이 지나갈때 소리질러 길을 비키게 하는 일
갈매기의꿈=미국의 소설가 리처드 바크의 갈매기를 주인공으로 한 우화소설. 갈매기 조나단 리빙스턴의 일생을 그린 작품.
갈사=더위를 먹어 죽음
감가불우=때를 만나지 못하여 뜻을 이루지 못함
감과=참외과의 과일.
갑절=어떤 수를 두번 합친 것. 8은 4의 ㅇㅇ이다.
강목=광석을 캘 때 감돌이 나오지 아니하여 소득이 없는 헛된 작업
강왕=몸이 건강하고 기력이 좋다.
강화미=인조미의 하나로 비타민 따위를 첨가하여 영양가를 높인 쌀
강활채=강활의 순을 데치어 소금과 기름으로 무친 나물
개관사정=관 뚜껑을 덮은 뒤에야 비로소 그 사람의 인간적 가치를 알 수 있음
개면=면사 방적 공장에서 면화의 섬유를 펴서 짧은 섬유와 티끌을 털어내는 일
개장=건물의 꾸밈새를 다시 고침
개지=종이에 쓴 글씨나 그림이 잘못되어, 새 종이에 다시 쓰거나 그림
개탄=분하게 여기어 탄식함
객꾼=뜻밖에 찾아온 사람
거가대족=대대로 번창한 높은 문벌의 집안.
거관=큰 구경거리
거냉=약간 데워서 찬 기운을 가시게 함.
거시=직접적으로 예를 들어 보임
거이기양이체=거처는 기상을 변하게 하고 먹고 입는 것은 몸을 달라지게 한다.
거지중천=허공
거춤거춤=일을 대충대충 하는 모양
거취=사람이 어디로 나다니는 움직임
거트=배드민턴이나 테니스 따위의 라켓의 줄
걱실걱실=성품, 언동, 생김생김 따위가 서글서글하고 활발한 모양
걱정=아랫사람의 잘못을 꾸짖음.
건습운동=식물의 세포벽이 공기가 건조하거나 습함에 따라 부풀어지거나 옴츠러드는 일
건주=주식거래에서 현재 매매가 약정되어 있는 주.
건축=저장한 곡식 따위가 말라서 양이 축남
검안경=시력 장애를 검사하기 위하여 수정체 등을 검사하는 기구.
검찰=형사 사건에서, 범죄의 형적을 수사하여 증거를 모으는 일.
겁결=겁이 나서 어쩔 줄 몰라 당황하는 참.
게이트=승마에서 문 모양으로 된 장애물을 통틀어 이르는 말.
게정=불평을 품고 하는 짓.
견사선=나비, 나방 따위에 발달해 있는 한 쌍의 분비선. 고치나 집을 만들기 위해 실을 분비함.
격고=임금의 거동 때에 원통한 일을 직소하기 위해 북을 치던 일
격세=해를 거름.
격양=감정, 기운 따위가 세차게 일어남.
격음화=거센소리되기
결가=값을 결정함
결기=발끈하기 잘하는 급한 기질
결미=글, 말, 일 등의 끝. 결말.
경력=겪어 옴. 거쳐 옴.
경매매=물건을 사고 파는 방법의 한 가지. 사는 쪽과 파는 쪽이 모두 복수로서 서로 경쟁하여 매매가 이뤄짐.
경스승=경문의 뜻을 풀어 가르치는 법사
경조상문=서로 경사에는 축하하고 흉사에는 위문함
경주=기울여 붓거나 쏟음
경천근민=하늘을 공경하고 백성을 다스리기에 부지런함
경체조=가벼운 기구를 사용하거나 맨손으로 하는 체조.
계모=계획과 모책
계서=뒤를 이음.
계주=2개 이상을 연결하여 사용한 전주
계축일기=광해군 때 영창대군을 역모로 몰아 죽일 때 인목대비가 겪은 일을 어느 궁녀가 일기체로 기록한 글.
고가교=땅 위로 높다랗게 놓은 다리. 구름다리.
고마=조선 시대에 지방 관아에서 백성으로부터 징발해 쓰던 말
고물=배의 뒤쪽이 되는 부분
고물대=돛을 두개 세운 배의 고물 쪽에 있는 돛대
고복=부모가 항시 자식에 대해 마음쓰는 일
고불=나이 많고 덕이 높은 중.
고비=편지 따위를 꽂아 두는 물건.
고비원주=자취를 감추고 멀리 달아남
고산유수=높은 산과 그 곳에 흐르는 물.
고숙=고모부
고용원=근로 계약에 따라 상대편에게 노무를 제공하는 사람. 
고침이와=베개를 높이 하고 편히 잔다
고콜=관솔불을 올려놓을 수 있도록 방 안 벽에 뚫어놓은 구멍
고흥=한창 일어나는 흥
곡제화주=곡식으로 만든 독한 술.
곡초식=땅심에 따라서 곡식과 목초를 번갈아 가꾸는 영농 방식. 
곤군=어렵고 군색하다
곤와=고단하여 드러누움
공공성=사회 일반이나 여러 단체에 두루 관련되거나 영향 따위를 미치는 성질
공공적적=우주 만상은 실체가 없는 공이며 사유를 초월해 있다
공단=감이 두껍고 무늬가 없는 비단
공산명월=사람이 없는 비어 있는 듯한 적적한 산에 비치는 외로이 밝은 달. 
공신력=실제로는 권리관계가 없는데도 있는 것으로 여겨지는 외형적 사실을 믿고 거래한 사람을 보호하기 위해 법률효과를 부여하는 효력
공업지대=공업 생산이 활발한 지역
공용물=국가나 지방 자치 단체 자체의 사용에 제공되는 공물
공자천주=공자가 시골 아낙에게 물어 구슬을 꿰었다.
공재=두 가지 이상의 대등한 것이 함께 존재함.
공정지가=토지대장에 등재 된 토지의 가격
교반기=어떤 물건을 섞거나 부수거나 또는 열을 골고루 전달시키기 위해 뒤섞어 휘젓는 기구나 장치
과유=과거를 보는 선비를 이르는 말.
과제=과거에 급제하다.
과채류=채소 가운데서, 그 열매를 식생활에 이용하는 식물을 이르는 말.
관능=생명을 영위하는 여러 기관의 기능
관등놀이=초파일에 하는 민속놀이. 집집마다 등을 담.
관망=갓과 망건을 이르는 말
관성=정답고 지극한 정성
관엽식물=잎사귀의 아름다운 모양이나 빛깔 등을 보고 즐기기 위하여 가꾸는 식물
관족=극피동물의 수관계에 붙은 발.
관후장자=관후하고 점잖은 사람
광대=지난날, 줄타기나 판소리 가면극 따위를 하던 사람을 통틀어 이르는 말.
광열비=전기, 가스, 석유, 연탄 등 조명이나 연료에 든 비용
광일미구=오랫동안 쓸데없이 세월만 보낸다는 뜻
광풍제월=시원한 바람과 맑은 달
교잡종=품질이 다른 것을 교배하여 만들어낸 종.
교주=사립학교의 경영자
교힐=능글맞고 매우 약다
구강위생=구강과 구강의 점막 및 이와 잇몸 따위의 질병 예방과 치료. ㅇㅇㅇㅇ에 신경을 쓰다.
구메구메=남모르게 틈틈이
구경증=한방에서 입과 혀가 뻣뻣해지고 차가워지는 어린아이의 병을 이르는 말
구구=각각 다르다
구달=말로 전달함.
구룡폭포=금강산에 있는 폭포로 가장 큼.
구들목=방안의 아랫목.
구미=입안이 허는 일
구석기=구석기 시대에 인류가 쓰던 악기
구수응의=여럿이 한자리에 모여 머리를 맞대고 의논함.
구신=자기의 의견이나 사정을 자세히 아룀. 윗사람에게 ㅇㅇ하다.
구약=말로 약속함.
구약현하=입에서 나오는 말이 경사가 급하여 쏜살같이 흐르는 강과 같다는 말.
구인=용의자나 피고인 등이 소환에 불응할 때 강제로 끌고 가는 처분
구입=겨우 빌어 먹음
구적=국토를 침범하는 외적
구증=말로써 증명함
구증구포=약재를 만들 때 아홉번 찌고 아홉번 말림.
구질=아흔살
구판장=조합 같은 데서, 생활용품 등을 공동으로 구입하여 싸게 파는 곳
국화주=감국의 꽃, 생지황, 구기자나무 뿌리의 껍질에 찹쌀을 섞어 빚은 술
군티=물건의 작은 흠
굴곡=이리저리 굽어 꺾이는 곳.
굽실=남의 비위를 맞추려고 비굴하게 행동하는 모양.
궁둥이=앉으면 바닥에 닿는 엉덩이의 아랫부분
굿중패=집집으로 꽹과리를 치고 돌아다니며 시주를 청하는 승려들의 무리
권도=수단은 맞지 않으나 결과에 따라 정도에 맞는 처리 방도
권양기=밧줄이나 쇠사슬을 감았다 풀었다 함으로써 물건 따위를 들어 올리고 내리는 기구
귀매취이=귀신과 도깨비가 가장 그리기 쉽다.
귀조=외국에 갔던 사신이 일을 마치고 본국으로 돌아옴.
귀틀집=굵은 통나무를 우물 정자 모양으로 귀를 맞추어 층층이 얹고 그 틈을 흙으로 메운 집.
규조토=규조가 쌓여서 된 퇴적물
그냥고지=모내기나 초벌 김매기 때 아침 곁두리와 점심만 얻어먹고 하는 고지
근지점=지구를 도는 달이나 인공위성이 궤도 위에서 지구와 가장 가깝게 접근할 때의 위치
금상학=금속이나 합금의 결정 및 조직 구조를 연구하는 학문
금시=바로 지금. ㅇㅇ라도 달려가고 싶은 마음.
금족령=어떤 장소를 드나들지 못하게 하는 명령
기경=생땅이나 묵힌 땅을 일구어 논밭을 만듬
기계=보통으로는 생각해낼 수 없는 기묘한 꾀
기근=공기뿌리
기기국=조선 말기에 병기를 만들던 관아
기대=무당이 굿을 할 때 음악을 맡은 사람
기도=어떤 일을 이루려고 꾀함.
기둥면=일정 방향의 직선이 일정한 곡선과 만나면서 움직일 때 그리는 면. 
기름콩=콩나물을 기르는 자디잔 흰 콩
기신=세상을 떠난 이의 제삿날을 높이어 이르는 말
기승=성미가 굳세고 억척스러워 남에게 굽히지 않음
기영=비행기의 그림자
기월=정한 기한의 달.
기전력=전류를 일으켜 전기 회로에 흘려 보내는 작용. 단위는 볼트.
기조=물고기의 지느러미의 뼈대를 이루는 가늘고 긴 뼈
기좌=경의를 표하기 위해 잠시 일어났다 앉음.
기주=증편 같은 것을 만들 때 반죽에 술을 부어 부풀어오르게 함
기지사경=사람이 죽을 지경에 이른 것
기진역진=기운이 없어지고 맥이 풀림. 기진맥진
기천=한방에서 가슴이 답답하고 숨이 차며 목구멍에서 가래소리가 나는 증세를 이르는 말
기추=조선 말기 무과의 시험 과목 중 한 가지. 말을 타고 달리면서 다섯 개의 목표물을 잇달아 활로 쏘아맞히게 하였음.
기축=무슨 일의 중심이 되는 부분.
기포성=액체를 그릇에 담아 흔들었을 때 거품이 이는 성질
기피=법률에서 불공정한 재판이 행해질 우려가 있을 때 그 법관의 재판을 소송 당사자가 거부함.
기함=기운이 푹 가라앉음.
기합술=정신을 집중하고 온몸의 힘을 한곳에 모아 어떤 힘을 나타내 보이는 술법
기호난하=이미 시작된 일을 중도에서 그만들 수 없음
기회=정기적인 모임
꽈리=가짓과의 한가지. 보라색 꽃이 핌.
끄트러기=쓰고 남은 자질구레한 물건
끈목=여러가닥의 실을 꼬거나 짜거나 땋아 만든 끈을 통틀어 이르는 말
끈히=끈질기게
나리꽃=백합의 꽃
낙산=산에서 내려옴, 또는 물건을 산에서 내림
낙수=가을걷이 후에 논밭에 떨어져 있는 곡식의 이삭
낙장거리=네 활개를 벌리고 뒤로 발짝 나자빠짐
낚시=물고기를 낚는데 쓰이는 바늘로 된 작은 갈고랑이
난태생=난생 동물이지만 알이 모체 안에서 깨어 유생이 되어 나오는 일
날치=날마다 갚는 이자
낭화=밀국수의 한가지. 보통 국수보다 굵고 넓게 만들어 장국에 끓임
내반슬=두 다리를 한 데 모으고 섰을 때, 무릎이 붙지 않고 바깥쪽으로 구부러진 상태의 다리. 오각.
내발뺌=어떤 일에 책임이 없음을 스스로 밝힘.
내수면=하천, 호소, 운하 따위의 수면
내연=가솔린이나 중유 따위의 연료가 기통 안에서 폭발
내청=연설, 강연 따위를 와서 들음.
냉동업=식품을 냉각, 냉동하여 보존하는 영업.
너리=잇몸이 헐어 이뿌리가 드러나며 이가 빠지는 병
노우지독=어미소가 송아지를 핥는다.
노마식도=늙은 말이 길을 안다
노명=이슬 같은 덧 없는 목숨
노소부정=노소엔 선후가 없다
노해=바닷가에 펼쳐진 들을 말하죠.
뇌졸중=뇌에 급격한 혈액 순환 장애를 일으키는 모양.
누기=눈물을 분비하고, 이 것을 비강으로 이끌어내는 기관을 통틀어 이르는 말. 
누전=물시계의 누호(漏壺) 안에 세운, 눈금을 새긴 화살
늘품=좋게 발전할 가능성
능라=두꺼운 비단과 얇은 비단
다다=될 수 있는 대로
다달다달=말을 자꾸 더듬는 모양
다듬잇돌=다듬이질할 때 밑에 받쳐놓는 도구.
다랑이=비탈진 산골짜기 같은 곳에 층층으로 된 좁고 작은 논배미
다식=녹말, 콩 따위의 가루를 꿀이나 조청에 반죽하여 00판에 박아 낸 음식
다식과=유밀과의 한 가지. 밀가루, 꿀, 기름, 생강즙, 소주 따위를 반죽한 다음 다식판에 박아내어 기름에 지짐.
다트=양재에서 몸에 꼭 맞도록 주름을 잡아 솔기가 겉으로 드러나지 않게 꿰맨 부분
다행다복=운수가 좋고 복이 많음.
단구법=붓글씨를 할 때 붓을 잡는 법
단미=꼬리를 자름
단발총=총을 쏠 때마다 총알을 한 발씩 재게 되어 있는 총.
단속곳=여자 속옷의 하나. 양 가랑이가 넓고 밑이 막혀 있으며 흔히 속바지 위에 덧입고 그 위에 치마를 입는다.
달막달막=흥분하여 가슴이 울렁이는 모양.
담대심소=문장을 지을 때의 마음가짐을 말한 것으로 담력은 크게 가지되 주의는 세심해야 한다는 말.
담하용이=말하는 것이 어찌 어렵겠느냐는 말.
당구=절에서 밥을 짓는 큰 솥을 이르는 말.
당궤=중국에서 만든 중국풍의 책상
대갓집=대대로 세력이 있고 번성한 집안.
대객초인사=손님을 대접하는 첫 번째 인사. 담배대접.
대동지환=모든 사람이 같이 겪는 환난
대등=낫고 못함이 없이 서로 걸맞음.
대리만족=대상행동이라고도 함.
대면=신라 때의 가면극의 한 가지. 금빛 탈을 쓰고 구슬채찍으로 귀신 쫓는 시늉을 함.
대못박이=대못이 뚫지 못하는 물건. 가르쳐도 깨닫지 못하는 둔한 사람.
대미사=가톨릭에서, 성대하게 지내는 미사?
대소인원=높고 낮은 모든 벼슬아치.
대방=여러 중이 한데 모여 밥을 먹는 절의 큰 방
대빈=높이 받들어 모셔야 할 귀한 손
대오리=가늘게 쪼갠 댓개비.
대일수=예전에 엽전 일만 냥을 이르던 말.
대장=신문의 한 면을 조판한 다음 지형을 뜨기 전에 마지막 대교를 하기 위하여 간단히 박아낸 종이
대장선=마루 밑 장선을 받치고 있는 나무
대접쇠=문장부가 들어갈 둔테의 구멍 가에 박는 말굽 같은 쇠
대포=거짓말이나 허풍을 말하는 말.
대하=보리새우
더펄이=성미가 덥적덥적하고 활발한 사람.
덕음=도리에 맞는 지당한 말
덜미=남사당패 여섯 놀이 중 마지막 놀이인 꼭두각시놀음.
덤받이=개가하여 온 아내가 데리고 들어온 자식
도가니=금속이나 철광석을 융해, 배소하는 등 고온처리에 사용되는 내열성 그릇. 자기, 백금, 흑연 따위로 만듬. 도ㅇㅇ. 
도광지=장사 지낼 때 무덤 속의 네 벽에 대는 흰 종이
도급기=두 나뭇가지의 한끝을 동여매어 집게처럼 만들고 그 틈에 벼 이삭을 넣고 벼의 알을 훑는 농기구
도내기=창을 끼거나 빼낼 수 있도록 홈이나 구멍의 어느 한 곳을 특별히 더 깊게 파낸 고랑이나 끌 구멍
도도록=가운데가 솟아서 조금 볼록하다.
도리기=여러 사람이 추렴하여 음식을 함께 나누어 먹는 일.
도문=과거에 급제하여 홍패를 가지고 집에 돌아옴. 
도수거=물줄기를 돌리기 위해 만든 암자
도읍=그 나라의 수도를 정함.
도파=끝까지 다 말함. 또는 딱 잘라 말함.
돌솜=석면
동공이곡=기량은 같으나 그 정취는 다르다.
동도지=동쪽으로 뻗은 복숭아나무의 가지
동령=겨울의 산마루?
동래서주=동쪽에서 와서 서쪽으로 가다
동몽선습=조선 중종 때, 박세무가 엮은 서당의 초급 교재.
동방화촉=부인의 방에 촛불이 아름답게 비침.
동상=겨울에 땅속의 수분이 얼어 지표면이 부풀어 오르는 일. ㅇㅇ현상.
동우=겨울에 내리는 매우 찬 비.
동청=동양화의 채색 기법의 한 가지.
동화조직=세포 속에 많은 엽록체를 가지고 있어 오로지 탄소 동화 작용만을 하는 조직.
된침=몹시 아프게 놓는 침.
두레상=여럿이 둘러앉아 먹을 수 있게 한 상
두름성=일을 주선하거나 변통하는 솜씨
두목=지난날 장사를 목적으로 중국 사신을 따라오던 북경 상인
두식=좀먹음
두장=천연두의 고름
둘암소=새끼를 낳지 못하는 암소
드림=매달아서 길게 늘이는 물건을 통틀어 이르는 말
득지=바라던 것이 뜻대로 됨
득담=남의 입길에 오르거나 구설의 거리가 됨
등대=분부에 따라 미리 갖춰두고 기다림
등변선=일기도에서 기압, 기온 따위의 기상 요소의 변화하는 정도가 같은 지점을 연결하여 나타낸 선
랑그=각 개인의 머릿속에 저장된 사회 관습적인 언어의 체계.
레이=하와이 사람들이 목에 거는 화환
리골레토=이탈리아 작곡가 베르디의 오페라. 베르디의 중기를 대표하는 걸작.
리벳=금속판 등을 잇는데 쓰는 대가리가 굵은 금속의 못
마고소양=마고라는 선녀가 가려운데를 긁어 준다. 일이 뜻대로 됨.
마르=화산지형의 한 가지. 마그마 속의 가스나 수증기의 약한 폭발로 이루어진 작은 화구.
마유=갓난아기의 유방에서 나오는 초유 비슷한 액체
마주르카=폴란드의 민속 춤곡
마중지봉=삼밭 속의 쑥이라는 뜻으로, 곧은 삼밭 속에서 자란 쑥은 곧게 자라게 되는 것처럼 선한 사람과
사귀면 그 감화를 받아 자연히 선해짐을 비유적으로 이르는 말.
막급=더 이상 이룰 수 없음. 후회가 ㅇㅇ하다.
막막궁산=인적이 없어 적막하도록 깊고 높은 산
막지=사막처럼 메마른 땅.
만건곤=하늘과 땅에 가득참
만단=만반. 여러가지. 온갖.
만록=여름철의 온갖 숲이 푸른 모양
만평=일정한 형식이나 체계 없이 생각나는대로 비평함.
말마디=조리가 바로 서는 말의 도막.
망건당=망건의 윗부분. 윗당줄을 꿰게 되어 있음.
망물=불교에서 죽은 중의 유물을 일컫는 말.
망변=망령되거나 조리에 닿지 않게 변론함.
망석중이=나무로 만든 꼭두각시의 한 가지.
망신=그릇되게 함부로 믿음
매개자음=낱말에서 모음과 모음의 충돌을 피하기 위하여 모음과 모음 사이에 덧들어가는 자음. 소+아지=송아지에서 'ㅇ' 따위.
매홍지=지난날 중국에서 들여왔던 붉은 빛깔의 종이
맥고지=밀짚이나 보릿짚의 섬유로 만든 종이
맥아=엿기름. 보리에 물을 부어 싹이 트게 한 다음 말린 것.
맹모단기=맹자의 어머니가 아들이 학업을 중단하고 돌아왔을 때 짜던 베를 칼로 잘라 훈계한 고사
맹인모상=전체를 보지 못하고 자기가 알고 있는 부분만 가지고 고집. 장인이 코끼리를 만진다.
맹랑=처리하기가 어렵다
멍추=총기가 없고 아주 흐리멍덩한 사람
면사=직접 만나 인사함
면지=책의 앞뒤표지와 속표지 사이의 종이. 한쪽은 표지 안쪽에 붙어 있음.
명경대=불교에서 이르는 저승길의 입구에 있다는 거울. 지나가는 이의 과거를 보여준다고 함.
명모호치=맑은 눈동자와 흰 이
명소부=임금의 명령을 받고 몰래 입궐하는 관원이 지니는 표
모가치=제 앞으로 돌아오는 한 몫의 물건.
모자=바둑에서, 변에 놓인 상대편의 돌을 누르기 위하여 위로 한 칸 걸러 놓는 수.
모방색=어떤 동물이 다른 동물과 같은 색깔을 띄는 일.
모밭=묘목을 기르는 밭
모켓=객차 따위의 의자 천으로 많이 쓰이는, 보풀이 있는 직물. 벨벳과 비슷함.  
몬드가스=질이 낮은 석탄을 가열하여 공기 및 다량의 수증기를 통하여 만드는 가스
무고지민=하소연하여 구원받을 데가 없는 백성.
무계지언=믿을 수 없는 말
무룡태=능력은 없고 착하기만 한 사람
무명=불교에서 영원히 변하지 않는 진리 4제의 근본의에 통달하지 못한 마음상태
무소외=두려워하는 바가 없음.
무의무탁=몸을 의탁할 곳이 없음
무인지경=사람이 없는 외진 곳. 이 곳은 심산유곡으로 가이 ㅇㅇㅇㅇ이라 하겠습니다.
무척=궁중에서 춤을 추는 남자
문미=문 위에 가로 댄 나무
문아=시문을 짓거나 읊거나 하는 풍류의 도
문설주=문짝을 세우기 위하여 문의 양쪽에 세운 기둥.
문조=참새과의 새.
문전작라=문 앞에 새그물을 친다. 문전성시.
문정약시=문앞과 정원에 사람이 많아 시장 같음.
문투=글을 짓는 법식
물미=땅에 꽂기 위하여 깃대나 창대 끝에 끼워 맞추는 끝이 뾰족한 쇠
물외한인=세상사에 관계하지 않고 한가롭게 지내는 사람
뭇매=여러 사람이 한꺼번에 덤비어 때리는 매.
미기=동안이 얼마 되지 않음
미농지=일본 고유의 종이.
미림=찹쌀밥에 소주나 누룩을 섞어 빚은 일본식 술. 맛이 달아 조미료로 씀.
미목수려=미목은 눈썹과 눈 얼굴모습이 대단히 아름다운 것을 가리킴.
미사리=삿갓이나 방갓, 전모의 안쪽에 대어 머리에 쓸 때에 걸려 얹히게 된 둥근 테두리
미색=겉껍질만 벗겨 낸 쌀의 빛깔과 같이 매우 엷은 노란색
미소=아양 부리는 웃음
미음=쌀을 푹 끓여 체에 걸러낸 걸쭉한 음식.
미편=편하지 않음
밑씨=수정한 뒤에 씨가 될 암꽃술의 기관. 배주.
바람벽=건물의 둘레나 칸살 사이를 막은 부분. 벽.
바이=아주, 전혀
박박이=틀림없이
박수례=박수로 하는 인사
박우물=바가지로 물을 뜰 수 있을 정도의 얕은 우물
*박정=인정이 없고 쌀쌀하다.
박치기=배의 널빤지 사이 또는 물이 스며들 틈을 쇠붙이로 메우는 일
반문농부=노반의 문앞에서 도끼를 자랑한다. 실력도 없으면서 잘난 척함.
반박지탄=한편으로 치우치는 불공정한 처사에 대한 개탄
반비=한복 저고리 위에 덧입는 웃옷의 하나로 깃과 소매가 없거나 아주 짧음
반삭=한달의 전반.
반세포=속씨식물의 체관 옆에 붙어 있는 길쭉한 세포. 체관에 공급하는 영양분의 저장 조직으로 알려져 있음.
반우=장사 지낸 뒤에 신주를 모셔 집으로 돌아오는 일
반장=객사한 사람을 살던 곳으로 옮겨 장사 지내는 일.
반지=얇고 흰 일본 종이. 세로 25cm, 가로 35cm 정도로 종이의 질은 질기고 거칠며, 종류와 쓰임이 다양하다.
반통=조선 시대, 성균관 대사성을 뽑을 때에 추천하는 세 사람의 후보자에 포함되던 일. ㅇㅇ에 오르는 것이 곧 그 학식과 인품을 인정받는 것이었다. 
반회장=여자 저고리의 끝동, 깃, 고름만을 자줏빛이나 남빛 천으로 꾸민 회장
발끈=어떤 일이나 상태가 갑자기 딴판으로 변하는 모양.
발적=염증 등으로 피부의 한 부분이 충혈하여 붉은빛을 띠게 되는 증상
발전=어떤 상태가 좋은 상태로 나아감.
밥풀과자=쌀로 튀기어 조청으로 버무려서 만든 과자
방게=바위겟과의 게. 방해.
방념=마음을 놓음
방망이=커닝을 하려고 글씨를 잘게 쓴 쪽지
방방=과거에 급제한 사람에게 증서를 주던 일
방위각=지평좌표계에서 지평선에 따라 측정한 천체의 방향을 나타내는 각.
방유=타이완에서 나는 방장을 증류하여 얻는 휘발성의 액체. 비누 향료로 쓰임
방출=비축해 둔 물자나 자금을 풀어서 일반에게 제공함.
배석판사=재판에서 합의부를 판사로 구성하는 경우 재판장 이외의 판사
백계무책=온갖 계책이 다 소용없음
백년하청=황하의 물이 맑아지길 기다림
백두산근참기=최남선이 지은 백두산 기행문.
백락일고=현명한 사람도 알아주는 자를 만나야 출세할 수 있음
백아=오릿과의 물새. 거위. 아조. 가안.
백의용사=전투시나 군사상 공무 집행 중에 상처를 입은 군인. 상이군인.
백일승천=정성스럽게 도를 닦아 육신을 가진 채 신선이 되어 대낮에 하늘로 올라감.
백태=눈병의 한가지. 눈에 ㅇㅇ가 끼다.
버디영화=남자배우 두 사람이 콤비로 출연하는 영화
버선등=버선의 발등에 닿는 부분.
벌임새=일이나 물건 따위를 많이 벌여 놓은 형편이나 모양
벌집위=소나 양과 같이 되새김질을 하는 동물에 있는 벌집 모양의 두 번째 위
범아귀=엄지손가락과 집게손가락의 갈라진 사이
법랑=금속기, 도자기 따위 표면에 구워 윤이 나게 하는 유약. 에나멜
법상=설법하는 중이 올라앉는 상
변류기=직류를 교류로 바꾸거나 반대로 바꾸는 기계.
변박=자기의 옳음을 주장하고 상대편의 잘못된 점을 지적하는 일. 
변성기=약한 전류의 회로에 끼우는 변압기
변자=물건의 가장자리에 대는 꾸미개
별시=나라에 경사가 있을 때나 병년마다 보던 과거
별장=이별의 아쉬움을 주제로 한 시문
병집=성격이나 행동 따위에서 깊이 뿌리 박힌 결점
벨로체=악보에서 빠르게라는 뜻.
보감=온갖 일을 처리하는 데 본보기가 될 만한 것들을 한데 모아 엮은 책
보답=남의 호의나 은혜를 갚음 
보라=국지풍의 하나. 헝가리의 고원에서 아드리아 해 연안으로 불어오는 강하고 한랭 건조한 동북풍이다.
보람=조금 드러나 보이는 표적.
보력=임금의 나이를 높이어 이르는 말
보본반시=근본에 보답하고 처음으로 돌아간다는 뜻.
보비=보조하여 돌봄
보사=물품 등을 보내어 은혜를 갚고 은덕에 보답함.
보사제=기우제를 지낸 뒤에 비가 오면 지내는 제사.
보일보=한 걸음 또 한 걸음
보자기=바다 속에 들어가서 조개나 미역 등 해산물을 따는 사람
보호석=어린이나 노인, 병약자를 보호하기 위하여 기차나 버스 따위에 마련한 좌석
복덕성=길한 별이란 뜻으로 목성을 달리 이르는 말
복서=더위를 먹음
복수불수=엎질러진 물은 다시 담지 못함
복조=복을 받는 것
봄의제전=러시아 출생의 미국 작곡가 스트라빈스키의 발레음악. 러시아 이교도들의 대지와 태양신에 대한 찬미를 제재로 한 회화적인 곡.
봉모=자식의 재주가 할아버지나 아버지에게 뒤지 아니함
봉봉=과즙이나 양주 같은 것을 사탕이나 초콜릿으로 싼 과자
봉승=웃어른의 뜻을 이어받음
봉지=물건을 담을 수 있게 종이 따위로 만든 주머니
부거=과거를 보러 감
부극=권세를 믿고 함부로 금품을 거두어들임
부동=그릇된 일을 하기 위하여 몇사람이 어울려 한통속이 됨
부동심=어떤 외계의 충동을 받아도 마음이 움직이지 않음.
부령=행정 각부 장관이 내는 법령.
부상=동쪽 바다의 해가 뜨는 곳에 있다고 하는 신령스러운 나무, 또는 그것이 있다는 곳. 부ㅇ 
부압=대기압보다 낮은 압력
부이=항만 안에서 배가 닻을 내리지 않을 때 잡아매려고 띄운 부표. 계선부표.
부적=남의 호적에 얹음
부전=장구의 줄을 고를 때 늦추었다 죄었다 하는 가죽 고리
부전부전=남의 바쁜 사정은 생각지 않고 자기가 하고자 하는 일만 하려고 서두르는 모양
분실=본부가 아닌 곳에 따로 마련한 사무실
분유=지하의 유전에서 석유가 땅 위로 높이 분출하는 일
분향재배=향을 피우고 두번 절함.
불목=집안끼리 또는 형제끼리 서로 사이가 좋지 아니함.
불입=납부. 학교 등 관계기관에 공과금, 수업료, 등록금 따위를 냄
비계=높은 곳에서 공사를 할 수 있도록 임시로 설치한 가설물
비단=물살이 센 여울
비량=이미 아는 사실로써 아직 모르는 사실을 미루어 아는 일.
비루=개나 나귀, 말 따위의 짐승의 피부가 헐고 털이 빠지는 병
비불능=할 수 있는 일을 안 함.
비상=비석을 태워 승화시켜 만든 결정체의 독약
비스름=거의 비슷한 듯 하다.
비장필천=고삐가 길면 밟힌다.
비정=인간다운 감정을 가지지 않음.
비제=자기 집을 낮추어 이르는 말.
비창=마음이 몹시 상하고 슬픔.
빙빙과거=어름어름하는 사이에 어느덧 세월을 다 보냄
사계=자기 혼자의 생각이나 계획.
사고기=여럿이 나누어 가져야 할 것을 혼자서 차지하는 물건
사곡=마음이 요사스럽고 바르지 못하다
사골=두 눈구멍 사이에 있는 벌집같이 생긴 뼈
*사금석=석영의 한가지. 점점이 빨간빛을 내므로 장식품으로 씀.
사달=대단찮은 사고나 탈
사도행전=신양성서(오타) 중의 한 편. 누가의 저작으로 베드로와 바울의 복음 행적과 초대 교회의 건설 및 발달 과정이 기록되어 있음.
사동=관청이나 회사 같은 곳에서 잔심부름하는 아이.
사래질=곡식을 키 따위로 살라서 굵고 무거운 것과 잘고 가벼운 것을 따로 가려내는 짓.
사령=네 가지 신령스런 동물
사망=장사에서 이익을 많이 보는 운수
사백사병=사람이 걸리는 모든 병을 이르는 말. 
사비팔산=사방으로 날리어 이리저리 흩어짐
사숙=남에게 자기 삼촌을 이르는 말.
사슬=조선시대 강경과의 등급을 표시하던 패. 통, 약, 조, 불의 글자를 썼음.
사시도=사철의 자연 경치를 그린 그림
사용세=소비세의 한가지. 유흥세, 입장세, 통행세 따위.
사통오달=길이 여러 군데로 막힘 없이 뚫림. 사통팔달
사한=사사로이 주고받는 편지
사형=나이와 학덕이 자기보다 높은 사람을 일컫는 말.
사함석=뱀이 겨울잠을 잘 때에 입에 물고 있다가 봄에 뱉은 흙덩이
사화=아름답게 수식한 시문
산보=불필요한 것은 없애고 모자란 것은 보충
산양유=염소의 젖
산허리=산둘레의 중턱.
삼상향=분향할 때 향을 세번 집어 불에 사르는 일
삼성오신=하루 세번 반성함.
상고대=나무나 풀에 눈같이 내린 서리. 몽송. 무송.
상기둥=안방과 마루 사이에 있는 가장 중요한 기둥
상면=서로 처음으로 만나 인사하고 알게 됨
상사불망=서로 그리워하며 잊지 못함
상쇠=농악에서 무리의 맨 앞에서 전체를 지휘하며 꽹과리를 치는 사람
상판=첫 판, 시작 판
새벽달=음력 하순의 새벽에 보이는 달
새줄랑이=방정맞고 경솔한 사람
색사지=잔치 때, 누름적 꼬챙이 끝에 감는 다섯 가지 빛깔의 종이 오리
색장나인=왕조 때 궁중에서 편지를 전하는 일을 맡아보던 나인
샘받이=샘물을 끌어대는 논.
생가슴=공연한 근심이나 걱정으로 상하는 마음
생가지=베어서 마르지 않은 나뭇가지
생반=선중에서 음식을 먹기 전에 아귀 또는 새와 들짐승 따위에게 주기 위하여 조금 떠내는 밥
생인=처음 보는 낯선 사람.
생중=술에 취하지 않았을 때
석분=지질시대 동물의 똥이 굳어서 된 화석.
석전경우=자갈밭을 가는 소
선광기=광물의 성질에 따라 광석을 분류하는 기계?
선도장치=시계가 좋지 않을 때 이용되는 레이더 유도 장치
선면=헝겊이나 종이를 바른 부채의 겉면
선시선종=처음이나 끝이나 한결같이 잘함.
선자=옛사람
선진배후수=먼저 물건을 바치고 뒤에 값을 받는 일
선면=헝겊이나 종이를 바른 부채의 겉면. 
선태식물=포자식물의 한 가지. 그늘지고 습기찬 곳에 잘 자라고 줄기, 가지, 잎의 구분이 없는, 고등 식물 중에 가장 원시적인 식물임.
설령=눈 쌓인 산 봉우리.
설리고=호두, 생강, 배 따위를 넣어 끓인 물에 꿀을 탄 약
설멍=옷이 몸에 어울리지 않게 짜름하다
설부화용=눈처럼 흰 살갗과 꽃처럼 고운 얼굴
설비=어떤 일을 하기 위한 건물 등 필요한 것을 갖춤.
섭산적=고기를 난도질하여 갖은 양념을 하고 반대기를 지어 구운 적
섭생=병에 걸리지 아니하도록 건강 관리를 잘하여 오래 살기를 꾀하는 방법
섭생=양생. 건강 유지와 증진에 힘씀.
성노=몹시 화를 냄.
성미=종교 단체의 신도들이 신에게 기도하거나 은총에 보답하기 위하여 정성껏 모아 바치는 쌀
성학가=천문으로 길흉을 점치는 사람
성호사서=성에 사는 여우와 신전에 사는 쥐. 임금 곁에 있는 간신의 무리를 말함.
성홍열=목의 통증과 함께 고열이 나고 두드러기가 돋으며 살갗이 빨갛게 되는 전염병
세여파죽=기세가 대나무를 쪼개는 것과 같다.
세부득이=사세부득이의 준말
셈평=이익을 따져 보는 생각
소네트=유럽 서정시의 한 형식인 14행으로 이루어지는 짧은 시.
소록소록=아이가 곱게 자는 모양.
*소망=기억에서 사라져 잊혀짐
소무=한국의 가면극에 등장하는 주요인물. 대개 기녀나 첩으로 분장
소복=원기가 회복됨
소소리패=나이가 어리고 경망한 무리
소액환=우편환의 한 가지. 어느 우체국에서나 현금과 상환할 수 있는 환증서.
소절=악보에서 세로줄과 가로줄로 구분된 마디
소치=시문의 우아한 운치
소화물=철도에서 여객이 휴대하지 않고 주로 여객열차에 탁송하는 작은 화물
속조=품위가 없는 속된 가락
속병=몸 속의 병을 통틀어 이르는 말.
손바람=일을 치러 나가는 솜씨나 기세
송도=파도 소리처럼 들리는 솔바람 소리
송백조=소나무나 잣나무처럼 변하지 않는 지조와 절개
송충목=송충이의 해를 입은 나무
수경성=석회나 시멘트와 같이 물을 섞으면 굳어지는 성질
수곡도=창자를 달리 이르는 말
수굿=고개 따위를 숙이는 모양
수나이=피륙 두 필을 짤 수 있는 감을 주어 한 필만 짜서 받고, 한 필 감은 삯으로 주는 일
수답=묻는 말에 말로 대답함
수대=같은 높이의 나무가 띠처럼 산기슭을 무성하게 둘러싸고 있는 곳
수도=감옥 속에 갇혀 있는 죄수
수두상기=실망해서 풀이 죽음.
수마력=일정량의 물을 일정한 높이로 올리는 데 필요한 동력
수맥=지하수의 물줄기. 수리.
수밀=큰 물통이나 관 따위가 속에 담긴 물을 조금도 흘리지 않고 수압을 견뎌내는 상태
수밀도=껍질이 얇고 과즙이 많은 복숭아의 한 품종
수반=꽃을 꽂거나 수석을 올려놓는 데 쓰는 쟁반
수발=수염과 모발
수불=받음과 치룸.
수시응변=임기응변
수양=버려진 아이나 남의 자식을 맡아 제 자식처럼 기름.
수영=재능과 기예가 뛰어나다.
수자직=옷감을 짜는 방법의 하나. 날줄이 적고 씨줄이 많게 하여 두껍고 윤이 남.
수장=장성이나 고급 장교 또는 경찰관 등의 정복 소매에 금줄 따위로 관등 같은 것을 표시한 휘장.
수정=물에 사는 요정
수졸=시세에 빨리 적응하지 못하고 우직한 태도를 고집함
수즉다욕=오래 사면 욕되는 일이 많다
수천방불=물과 하늘이 거의 비슷하다
수포진=살갗에 물집이 잡히는 발진. 주위에 열이 오름.
수필=붓촉 전체를 먹물에 적시어서 쓰는 붓.
숙경=삼가 존경함.
숙황=풍년으로 쌀 값이 내려 농민이 도리어 곤궁해지는 일
순경=환경이나 경제적 조건 등이 좋아서 모든 일이 뜻대로 이루어진 경우. <-> 역경
순지르기=잘 가꾸려고 쓸데없는 순을 잘라 냄
순화=기후가 다른 지역에 옮겨진 생물이 점차로 그 환경에 적응하는 체질로 변하는 일
술덤벙물덤벙=세상 물정 모르고 함부로 날뛰는 것
술도가=술을 만들어 도매하는 집
스목=의복 위에 덧입는 길고 넉넉한 작업복.
스콥=흙 따위를 파거나 담아 올리거나 섞는 데 쓰는 숟가락 모양 기구
승승=대가 끊어지지 않음
승천입지=하늘에 오르고 땅 속에 들어간다. 자취를 감추고 없어진다.
시구=사람의 죽은 몸. 송장. 시체.
시마=지질학에서 지각의 하층부를 이르는 말.
시사=윗 사람을 모시면서 문서를 작성 처리하는 사람
시술=수술을 함.
시주=자동차의 성능 등을 시험해보기 위해 처음으로 운전해보는 일.
시처위=때와 장소, 지위
식분=일식이나 월식 때 해나 달이 이지러진 정도.
식전바람=아침밥을 먹기 전의 이른 때
식소사번=먹는 것은 적은데 일만 번거로움.
신구=말을 삼가지 않고 입에서 나오는 대로 말함.
신무=뛰어난 무덕
신체=신령의 상징으로 예배의 대상이 되는 물체.
신하=새로 들어온 물품을 말하는 말.
심기증=스스로 생각하기에 큰 병에 걸렸다고 느끼는 증세
심장=마음의 속내. 감정이 우러나는 속 자리. ㅇㅇ이 상하다.
실권주=신주 인수권자가 청약 기일까지 청약하지 않거나 돈을 내지 않아 인수되지 않은 주식
실내공식=건축물의 내부를 그 쓰임에 따라 아름답게 꾸미는 일
실리주의=형벌은 사회 방위의 수단으로서, 사회의 필요와 실익에 기인한다는 법리상의 주의. ㅇ리ㅇㅇ.
실마치구=말 잃고 마굿간 고친다.
실머슴=굳은 일을 마다하지 않는 성실한 머슴.
실언실인=헛된 말로 말을 잃어버리고, 터놓고 말을 하지 않아 사람을 잃는다는 뜻
심전=마음, 심지.
심전계=심장의 고동을 전위차의 변화로 나타나게 하여 재는 장치
십자고상=십자가에 못박힌 예수의 수난상
싱승생숭=마음이 들뜨고 어수선한 모양.
쌍반점=<;>의 이름. 세미콜론
쑥덕공론=남이 알아듣지 못하게 저희들끼리 모여 쑥덕거리는 짓.
아귀=씨앗의 싹이 터서 나오는 자리
아미=누에나방의 눈썹처럼 아름다운 미인의 눈썹.
아사리=제자를 가르치고 제자의 행위를 바르게 지도하여 그 모범이 될 수 있는 고승.
아세=동지를 달리 이르는 말
아이스하켄=등산에서 빙벽을 오를 때 빙벽에 박아 두는 금속쐐기
아한대=온대와 한대의 중간에 있는 지역
안고수저=눈은 높으나 재주가 못 따라감.
암전상인=어두울 때 화살을 쏘아 사람을 다치게 한다. 남몰래 사람을 다치게 하는 것.
암합=우연히 일치함
앙감질=한 발은 들고 한 발로만 뛰어가는 짓.
야광=달이 없는 맑은 밤하늘이 얼마간 환해 보이는 현상
야기죽야기죽=맵쌀스럽게 재깔이며 빈정거리는 모양.
야상곡=형식이나 내용이 자유로운 낭만파의 피아노를 위한 소곡
야지=산이 좁고 들이 넓은 지대
약롱중물=약농 속의 약품.
약본력=본력을 바탕으로 하여 일반인의 일상생활에 필요한 것만 가려서 간략하게 만든 달력
약용식물=약으로 쓰이거나 약의 원료가 되는 식물.
약점=부족하거나 불완전한 점. ㅇㅇ을 보완하다.
약진=약을 먹거나 주사를 맞은 뒤 얼마되지 않아서 피부에 나타나는 발진
약초구=고기는 없이 채소만 가지고 차린 맛없는 음식
양수표=강, 호수, 바다 등의 수위를 재기 위해 마련한 눈금 있는 기둥
양재기=알루미늄으로 된 식기
양재사=양복을 마르거나 바느질하거나 디자인하는 사람.
양주=부부를 남이 대접하여 일컫는 말
양지=경험이나 교양에 의한 것이 아니라 타고난 지능
양추=서늘한 가을. 음력 9월을 달리 이르는 말.
어거=말이나 소를 모는 일. 데리고 있으면서 바른길로 나가게 함.
어둠상자=사진기에서 렌즈로만 빛이 들어오게 하는 상자 모양의 장치.
어리=문을 다는 곳. 문 위틀과 문지방, 좌우 문설주를 통틀어 이르는 말이다
어목연석=물고기의 눈과 중국 옌산에서 나는 돌. 사이비의 사물.
언거번거=쓸데없이 말이 많고 너무 수다스럽다
엄지=지난날 어음을 쓰던 종이를 이르던 말
엄홀=아주 급작스럽다.
업시름=업신여겨서 하는 구박
업차=그날그날 일의 순서
여리꾼=가게 앞에 서서 지나가는 사람을 가게 안으로 끌어들여 물건을 사게 하는 사람
여송연=루손 섬에서 나는 향기가 좋은 엽궐련
여호모피=여우나 호랑이에게 가죽을 벗으라함. 사실상 불가능한 일.
역신=천연두를 말함.
역전=적으로부터 공격을 받다가 역습하여 싸움.
역혼=동생이 먼저 결혼함. 도혼
연립=둘 이상의 것이 어울리게 성립함.
연면=무슨 일이 오래 계속되어 끊이지 않음
연모=물건을 만들거나 무슨 일을 하는 데 쓰는 기구 
연자=글 속에 잘못 들어간 쓸데없는 글자
연출=어떤 행사나 집회를 효과적으로 진행시키는 일.
연야=밤마다
연임=임기를 마친 사람이 다시 그 자리에 임용됨.
연질미=물기가 15%이상 함유되어 변질되기 쉬운 현미
열구자탕=신선로에 여러 가지 고기, 생선, 채소, 과일을 넣고 갖은 양념을 넣어 끓인 음식
열용량=물체의 열량을 1도씨 올리는 데 드는 열량
열차원=여객 열차 에서 차장을 도와 여러가지 일을 보살피는 승무원.
염문=몰래 물어봄
염사지변=실은 물들이는 색에 따라 색깔이 달라진다
영곡=영남에서 나는 곡삼을 이르는 말
영관=빛나는 승리나 영예로운 지위.
영걸=큰일을 이룰 수 있을 만큼 용기와 재지가 뛰어남.
영신=간사하게 아첨하는 신하
영애=남을 높이어 그의 딸을 일컫는 말
영이=헤아릴 수 없이 신령스럽고 경이롭다.
오가리=박, 호박, 무 따위의 살을 가늘고 길게 오려 말린 것.
오국=나라를 그르침
오니=더러운 흙. 슬러지
오비일색=날고 있는 까마귀가 모두 같은 빛깔
오상=가톨릭에서 그리스도가 수난을 당할 때 입은, 양손, 양발, 옆구리의 다섯 상처를 이름.
오수정=검은 빛깔의 수정
오심=한방에서 속이 불쾌해지면서 토할 듯한 기분이 생기는 증상을 이르는 말
오촌정=다섯 치 길이의 쇠못
온도풍=기온의 수평분포에 의해 생기는 바람
옴죽=몸의 한 부분을 조금 옴츠렸다 폈다가 하는 모양
옷고름=저고리나 두루마기의 깃을 여매기 위하여 깃 끝과 그 맞은 편에 단 헝겊 끈
옹이=나무에 박힌 가지의 그루터기
용두=문과의 장원
옹추=자기가 늘 미워하는 사람. 중국 한나라의 고조가 미워하단 사람의 이름이 옹치였던 데에서 유래함.
용해도=포화 용액 속에 들어 있는 용질의 농도.
용혈소=적혈구를 파괴하고 헤모글로빈을 유출시키는 물질
왁저지=무를 굵게 썰고, 고기나 다시마 따위를 넣고 양념하여 지진 반찬
왈패=언행이 단정하지 못하고 수선스러운 사람을 속되게 이르는 말. 왈짜.
원골=원한을 품고 죽은 사람
원소병=음력 정월 보름날 밤에 먹는 떡
원수가=효성왕 때 신충이 지었다고 하는 향가. 임금이 약속한 것을 지키지 않음을 원망
월진승선=나루를 건너가서 배를 탄다는 뜻.
월차=하늘에서 달의 위치를 이르는 말
우금=시냇물이 급히 흐르는 가파르고 좁은 산골짜기
우사생풍=일을 보면 바람이 인다. 사사건건 문제를 일으킨다.
우음마식=소처럼 마시고 말처럼 먹는다.
욱기=욱하는 성질
운량=구름이 하늘을 덮은 비율
운조술=배를 부리는 기술
위경련=위궤양이나 담석증, 충수염 따위로 위가 오그라지며 심한 통증을 일으키는 병증.
위려마도=숫돌을 위해 칼을 간다. 주객이 전도됨.
유들유들=부끄러운 줄 모르고 뻔뻔한 데가 있는 모양.
유락=고향을 떠나 타향에 삼.
유리체=수정체와 망막 사이의 안구 속을 채우고 있는 반고체의 투명한 물질
유보약관=외국법의 적용에서 그 결과가 사회의 질서에 위반될 때, 그 적용을 배척할 수 있는 경우를 규정하는 국제 사법상의 예외 규정
유삼=비나 눈을 막기 위하여 옷 위에 껴입는 기름에 결은 옷
유유낙낙=명령하는 대로 언제나 공손히 승낙함.
유여=여유가 있다. 넉넉하다.
유인=속세를 피해 그윽한 곳에 숨어 사는 사람
유인=어떤 작용을 일으키는 직접적인 원인
유장=기름종이로 만든 천막을 일컫는 말.
유전=채무자가 변제기한잠시 머무름.
유창=소 창자의 가장 긴 부분. 국거리로 씀.
육사=고려 시대에, 주요한 나랏일을 맡아 보던 여섯 관청.  곧, 군부사, 예의사, 전공사, 전리사, 전법사, 판도사.
육신=민속에서 오방을 지킨다는 여섯 신. 현무, 청룡, 주작, 백호, 구진, 등사를 이름.
유진=행군하던 군대가  같이 남녀 한 쌍이 추는 경쾌한 사교춤
율모기=뱀과의 동물. 몸에 큼직큼직한 검정 얼룩점이 있음. 유혈목이.
은구=썩 아름답게 쓴 글씨를 비유하여 이르는 말
은산덕해=산 같이 큰 은혜, 바다같이 큰 덕
응집소=응집 반응을 일으키는 항체
의문자수=남의 집 문전에서 걸식을 하여 간신히 끼니를 이어나가는 상태
의빈=부마도위 따위와 같이 왕족의 신분이 아니면서 왕족과 통혼한 사람을 통틀어 이르는 말
의위=의식을 장엄하게 하기 위해 참렬시키는 호위병
의준=청원을 들어줌
의타심=남에게 의지하는 마음.
이념=철학에서 모든 경험에 통제를 부여하는, 순수 이성에서 얻어진 최고의 개념.
이도살삼사=복숭아 두 개로 무사 세 명을 죽인다.
이맛전=이마의 넓은 부분
이목일신=귀에 들리는 것 눈에 보이는 것 모든 것이 새로운 모습
이소성=새의 새끼가 빨리 자라 둥지에 오래 머물지 않는 성질
이어=귓속말
이어중=뭇사람보다 뛰어남
이주화=수꽃과 암꽃이 서로 다른 나무에서 피는 꽃
이축=건물을 옮겨 세움.
이취=이상한 냄새
이판화=갈래꽃. 꽃잎이 서로 떨어져 있는 꽃.
인간고=사람이 세상을 살아가는 데 따르는 고통이나 번뇌
인기=사람의 도량과 재간.
인개=어류와 패류를 이르는 말.
인면=사람의 얼굴.
인보=이웃끼리 서로 힘을 다해 돕는 일
인용어=남의 글이나 말에서 끌어다 쓴 말. 따옴말.
인자=글자를 찍음. 또는 그 글자.
인자위전=사람은 모두 각자의 전법을 갖고 있음. 누구나 다 자기 살길을 찾음
인적기=사람이 다니는 기척
인정세태=세상 물정과 세상 사람들의 마음
인형=편지글에서 친구 사이에 서로 상대편을 높이어 일컫는 말
일숙일반=여행길에 하룻밤 숙박하며 한 끼 신세짐
임심리박=깊은 곳에 임하듯 하며 얇은 데를 밟듯이 세심히 주의(注意)하여야 함
자경=철학에서 자기 인격의 절대적 가치와 존엄을 스스로 인정하는 일을 이르는 말.
자고=꿩과의 새. 메추리와 비슷함
자기=백토 따위로 구워 만든 그릇.
자당=상대편의 어머니를 높여 이르는 말. 대부인.
자대=스스로 잘난 체 함
자량=스스로 헤아림
자력계=자기장의 세기와 그 방향을 측정하는 장치.
자릿장=이부자리를 넣어 두는 장롱
자배기=질그릇의 한 가지. 소래기보다 운두가 약간 높음.
자복=실력 있는 사람이 때를 기다리며 숨어 지냄.
자분자분=성질이 찬찬하고 부드러운 모양.
자비심=자기 자신을 못나게 여기는 마음 
자소=자기 죄를 고백함
자승=스스로 자기가 남보다 나은 줄로만 여김
자시=고집스럽게 자기 의견만 옳은 줄로 여김.
자심=점점 더 심해짐
자연증수=국민 경제의 성장으로 세율 따위를 올리지 아니하여도 재정 수입이 저절로 느는 일.
작법자폐=자기가 만든 법에 자기가 걸려 죽음
작설차=차나무의 어린 새싹을 따서 만든 차
잡도리=단단히 준비하거나 대책을 세움. 또는 그 대책
잡힐손=무슨 일에든지 쓸모가 있는 재간.
장관이대=장가의 관을 이가가 쓴다. 이름과 실상이 맞지 않음.
장꾼=장에 모여 물건을 사고 파는 사람들.
장두상련=창자가 서로 잇닿아 있다. 배짱이 서로 잘 맞음.
장도=중대한 사명이나 장한 뜻을 품고 나서는 길
장독간=장독을 놓아두는 곳.
장로=불교에서 고승을 이르는 말.
장용제=약의 거죽을 젤라틴으로 싸서 위에서는 녹지 않고 장에 들어가서 녹게 만든 약제
장자=덕망이 있고 노성한 사람.
장자석=발전기나 전동기 따위에 쓰이는 강한 자기장을 일으키기 위한 전자석
재중=속에 들어있음의 뜻으로 봉함한 봉투 겉에 쓰는 말
잼버리=보이 스카우트의 대회.
저큼=잘못을 고치고 다시 잘못하지 않도록 조심함
적공=어떤 일에 많은 공을 들임
적량=적재량.
적심=초목의 곁순을 잘라내는 일?
적적상승=대대로 적파의 장자, 장손이 가계를 이어 내려옴
적화=차나 배 따위에 화물을 실음
적부루마=붉은빛 털이 섞인 흰빛의 말
전고=뒤에 남길 목적으로 자기 일대기를 적어놓음
전리=중성의 원자나 분자가 전기를 띠게 되는 일
전물=신불에게 올리는 물건
전민=가슴을 태우며 근심하거나 걱정함
전벽=창이나 문이 전혀 없는 벽
전봇줄=전선을 이르는 말. ㅇㅇㅇ에 내려앉은 참새들.
전장=소유하고 있는 논과 밭
전장총=탕약을 총구로 재는 구식 소총
전포=지난날 장수가 군복으로 입던 긴 웃옷
절가=혈통이 끊겨 상속자가 없게 됨. 또는 그런 집안
절미=쌀을 아낀다는 뜻
정감=사람의 마음에 호소해 오는 것 같은 느낌이 듬.
정수식물=수생식물의 한가지. 뿌리는 물속의 땅에 내리고 잎이나 줄기 따위는 물 위로 뻗음. 연꽃, 갈대 따위.
정작=막상. 정말로. 실지로.
정장제=장의 전반적인 기능을 좋게 해주는 약.
정평=사람마다 다 같이 인정하는 평판
정합국=여러 독립국들이 대외 문제를 처리하기 위해 결합한 연합국의 한 형태.
젖니=배냇니. 유치.
제물로=그 자체가 스스로
제적=등록되어 있는 명부에서 이름을 지워 버리는 것.
조도=일찍 도착함
조마사=말을 길들이는 사람
조바위=추울 때에 여자가 머리에 쓰는 물건.
조상=손톱이나 발톱에 긁혀서 생긴 생채기
조시=무엇이 비롯되거나 비롯함, 또는 그 시초.
조심누골=마음에 새겨지고 뼈에 사무친다. 몹시 고생함.
조어=새가 지저귀는 소리. 미개인들이 지껄이는 소리를 이르는 말.
조왕모귀=아침에 갔다가 저녁에 돌아옴
조제=죽은 사람의 영혼을 위로하기 위하여 제사함.
조충서=왕망의 한자 글씨체 중 하나. 새와 벌레의 모양을 본뜸.
*조홍=얼굴이 붉어지는 일
족부권=족장이 가진 그 족속에 대한 지배권
종과득과=오이를 심으면 오이가 난다
종발=중발보다는 작고, 종지보다는 조금 넓고 평평한 그릇
종주먹=상대방을 위협하는 뜻에서 드는 주먹
종콩=주로 메주를 쑤는 데 쓰는, 알이 자잘한 흰콩
종학=남의 학문을 좇아 배움
주경=글씨나 그림 따위의 필치가 굳세고 힘셈.
주금류=조류의 한 무리. 날개가 퇴화됨.
주대=낚싯줄과 낚싯대
주리=살갗에 생긴 자디잔 결
주석=포도주를 만들 때 발효가 진척되어 알코올이 증가함에 따라 밑으로 가라앉는 물질
주승=한 절의 주지로 있는 스님.
주찬=형벌로 죽이는 일과 귀양 보내는 일.
주천=천체가 한바퀴를 도는 일
죽대=백합과의 다년초. 높이는 50cm 정도이며 잎은 어긋나고 긴 타원형의 피침 모양이다
죽데기=통나무의 겉 쪽에서 떼어낸 조각. 주로 땔감으로 씀.
죽장기=서투른 장기
죽장사=가늘게 쪼갠 댓개비를 결어 만든 상자
준조절충=술자리에서 적의 창끝을 꺾는다. 평화로운 교섭으로 흥정함.
줄거리=잎자루 잎줄기 잎맥을 통틀어 이르는 말
중리=복리
중새끼=어미만큼 자란 새끼
중혀=한방에서 혓줄기 옆에 청백색의 물집이 이는 종기를 이름.
즈크=실이나 무명실로 두껍게 짠 직물.
지가스=무색, 무미, 무취의 액상 독가스
지기=땅의 눅눅한 기운. 음의 기운.
지공무사=더 없이 공평하고 사사로움이 없음.
지란지화=좋은 친구와 사귀는데 있어 자연히 그 아름다운 덕에 감화됨.
지단=넓은 땅을 몇 단으로 나누어 가른 때의 한 구역
*지대기=이리저리 떠돌며 수양하는 승려의 의복 따위
지두문=도자기에 잿물을 덮은 위에 손가락 끝으로 아무렇게나 그린 무늬
지등롱=기름에 결은 종이로 집을 만들어 들고 다닐 수 있도록 한 등
지런지런=물체의 한끝이 다른 물체에 가볍게 스치거나 닿을락 말락 하는 모양.
지며리=차분하고 꾸준히
지상권=다른 사람의 토지에서 공작물이나 수목을 소유하기 위하여 그 토지를 사용할 수 있는 물권.
지시=증권상의 기재에 따라 어떤 사람을 권리자로 지정하는 일
지오=서로 어긋남. 맞서서 겨우 버티어 감.
지우이신=지극히 어리석은 사람에게도 신령한 마음이 있을 수 있음. 백성의 마음을 비유하여 이르는 말.
지족불욕=분수를 지켜 만족할 줄 아는 사람은 욕되지 아니함.
지중=더 할 수 없이 귀중하다.
지청구=까닭 없이 남을 탓하고 원망함
지칭개=국화과의 이년초
지피=땅의 겉면을 덮고 있는 잡초나 선태류
지형=활판 인쇄의 연판을 만들기 위한 본. 특수한 판지를 눅여서 식자판의 판면을 대고 눌러 본을 뜬 것.
진탕만탕=더 없이 많고 만족스럽게.
진찰=경상남도 관찰사를 이르는 말
질뚝=길쭉한 물건의 한 부분이 깊이 패어 움푹하다
짐받이=자전거 따위의 뒤에 짐을 싣는 시렁 같은 물건.
징표=다른 사물과 구별하여 그것이 무엇인가를 나타내 보이는 지표가 되는 것.
짜장=참. 과연. 틀림없이 정말로.
찔꺽찔꺽=진흙이나 풀 따위를 짓이길 때와 같이 몹시 끈진 모양 혹은 소리.
차계기환=손님을 박대하는 것을 빗대어 이르는 말
차기=책을 읽으며 느낀 바를 그대로 적어 놓음.
차떼기=어떤 상품을, 화물 자동차 한 차에 얼마로 값을 쳐서 모개로 사들이는 일, 또는 그렇게 하기 위한 흥정.
차비=왕조 때 특별한 사무를 나누어 맡기기 위해 임시로 임명
참꽃=먹는 꽃이란 뜻으로 진달래꽃을 이르는 말
창경=유리문이 아닌 창문에 단 유리
*창주양사=없으면서도 많이 있는 척함을 비유한 말
채미=고비나 고사리를 캠
채미가=고사리를 캐는 노래라는 뜻. 백이와 숙제의 얘기를 담은 절의로운 노래.
*채변=남이 무엇을 줄 때 사양하는 일
*채화석=여러가지 고운 무늬를 놓아서 짠 돗자리
책선=친구끼리 착한 일을 서로 권함
챗돌=지난날, 타작할 때 개상 위에 올려 놓고 벼를 태질하던 돌
척단촌장=척(尺)도 짧을 때가 있고, 촌(寸)도 길 때가 있다
천경지위=하늘이 정하고 땅이 받드는 길
*천상수=비가 내려서 괸 물.
천서=하늘이 내리는 상서로운 징조
천선=북두칠성의 하나. 국자모양의 앞쪽 아래의 별.
천수통=절에서 승려가 밥을 먹은 뒤에 바리 따위를 씻은 물을 거두는 통.
천재=오랜 세월. 천세.
천진전=대종교에서 단군의 영정을 모신 사당
천향국색=천하제일의 향기와 자색. 모란꽃을 이르는 말.
철석간장=굳세고 단단한 의지. 철심석장.
첩어=같은 소리나 비슷한 소리의 단어가 겹처 이뤄진 합성어
첩지=대한 제국 때 최하급의 관리인 판임관에게 내리던 임명장
청구멍=청탁을 할 자리나 길
체불=마땅히 지급할 것을 지급하지 못하고 미룸.
체사=울면서 흘리는 눈물이나 콧물
초눈=초파리의 애벌레
초동급부=땔나무를 하는 아이와 물을 기는 아낙네
초면=기름에 볶은 밀국수
초사=처음 벼슬길에 오름
초어=나무하는 일과 고기잡는 일
*초한=살을 찌르는 듯한 추위
촉수=잉어, 메기, 미꾸라지 등 입 언저리의 수염
최고=법률상 일정한 결과를 일으키기 위해 상대편의 행위를 재촉
최상선=철학에서 의무감 때문에 도덕이나 법에 따르려는 마음가짐을 이르는 말
추접지근=깨끗하지 못하고 너저분하다.
추지=유추하여 알아냄.
추후=일이 지나간 얼마 뒤. 이 다음.
출천지효=하늘이 낸 효자란 뜻
충순=마음이 충성스럽고 참되다.
취명=사이렌 등을 불어 울림
층샛돌=층새와 황금을 나란히 문질러서 황금의 색을 분별하는 데 쓰는 검은 돌.
층층시하=부모와 조부모를 다 모시고 있는 처지
치란=혼란에 빠진 세상을 다스림
치륜=톱니바퀴
치마=연에서 위쪽 절반은 흰 종이로 아래쪽 절반은 색종이로 만든 것의 아래쪽을 가리키는 말
치인설몽=바보에게 꿈 이야기를 해준다. 이야기가 상대에게 이해되지 않음.
치중점=바둑에서 사활이 결정될 급소의 한 점
콜리=개의 한 품종. 얼굴이 길고 코끝은 가늘며, 털은 누런 갈색. 스코틀랜드가 원산지로 목양용, 애완용으로 기른다.
쿠미스=몽골, 시베리아 등지에서 말이나 낙타젖으로 만든 발효유. 알코올 성분 2.3%
크낙새=딱따구릿과의 새. 우리나라 특산종으로 기념물 제 197호.
키들키들=억누르지 못하여 입속으로 자꾸 웃는 소리
키꼴=키가 큰 체격을 속되게 이르는 말.
타울타울=목적한 바를 이루려고 바득바득 애를 쓰는 모양.
탐지=드러내지 않은 물건이나 사실을 더듬어 찾음.
탕기=국이나 찌개 따위를 떠놓는 자그마한 그릇을 세는 단위.
태산준령=큰 산과 험한 고개.
터보건=눈 위를 활강하는 스포츠용 목제 썰매
터줏고기=일정한 곳에서만 깃들어 사는 물고기
토분=진흙의 보드라운 앙금을 말린 흙가루.
토시살=소의 만화에 붙은 고기.
토옥=땅이 기름지다.
토정=속을 터놓는 것. 토로.
통거리=어떤 사물을 가르지 않고 모두
퇴주잔=제사 때 올린 술을 물린 술잔
투고=신문사, 잡지사 따위에 원고를 써서 보냄
투심=미워하고 강샘하는 마음
트립신=췌장에서 분비되는 소화 요소의 한 가지. 장내에서 단백질을 가수 분해하여 아미노산을 만듦.
패관잡기=조선 명종 때 어숙권이 지은 책. 잡다한 내용을 자유롭게 서술.
패국=쇠하여 약해진 형국
패분=조가비를 부순 가루
평활=연습할 때 쓰는 활.
포육=동물이 자기 새끼를 먹여 기름.
포장수력=하천이 지닌 잠재적 발전 능력
표리=왕조 때 임금이 신하에게 내리거나 신하가 임금에게 바치던 옷의 겉감과 안감. ㅇ리.
표지등=야간에 운행하는 선박, 비행기 따위가 그 위치를 표시하는 등을 이른다.
푼수=얼마에 상당하는 정도 또는 능력
풀무치=메뚜깃과의 곤충. 몸의 길이는 4.8~6.5cm이며, 누런 갈색 또는 초록색이고 앞날개에 불규칙한 검은 갈색 무늬가 있다.
풋머리=곡식, 과일 따위의 제철이 되기 이전의 맏물 정도가 나돌 무렵
풍감=용모와 풍채로써 그 사람의 성질을 감정함
풍적토=바위의 부스러기가 바람에 불려 가 된 땅.
풍조=세상이 되어가는 추세
풍운지회=용이 구름을 타고 범이 바람을 만남. 군주가 현신을 만나는 절호의 기회.
피로=문서 따위를 펴 보임.
피장=짐승의 가죽을 다루는 장인
필업=사업이나 학업을 마침
하무=군졸이 떠들지 못하도록 입에 물리던 나무
하인=누구
하상=따지고 보면, 도대체
하신=강줄기의 물이 흐르는 부분
하직=먼 길을 떠날 때 웃어른에게 작별을 고함. 
하혈=항문으로 피를 쏟음.
학부득=배워도 따라가지 못함
한바다=매우 깊고 넓은 바다
할거=베어 버림. 찢어 버림.
항해사=해기사 면허증을 가지고, 측량 등 선박 운행의 업무를 담당함?
해감=흙과 유기 물질이 섞여 물속에 생기는 냄새나는 찌끼.
해골=생각하는 머리를 속되게 이르는 말
해로동혈=살아서는 같이 살고 죽어서는 한 무덤에 묻히다.
해사=사리를 자세히 앎.
해상=배에 물건을 싣고 다니면서 하는 장사.
해안도=육지의 한 부분이 떨어져 나가 섬이 된 것.
해저목장=성게, 전복 등을 바다에서 양식하는 곳.
해중전=양쪽 잠수함끼리 벌이는 바다 속 전투
해죽=흡족한 듯이 귀엽게 웃는 모양
해찰=일에는 정신을 두지 않고 쓸데없는 짓만 함.
행망=요행을 바란다
행여=어쩌다가라도 운 좋게
행자반=은행나무로 만든 소반
향일=접때. 지난 날.
허방=움푹 팬 땅. 함정을 'ㅇㅇ다리'라 한다.
현량자고=머리를 대들보에 묶고, 송곳으로 다리를 찔러 가며 공부함.
호기만발=거드럭거리며 뽐내는 기운이 온몸에 가득 차서 겉으로 드러남.
호세=크고 강한 세력
호야곡=선조 때 조존성이 지은 네 수의 시조. 초장 첫 구가 모두 아희야로 시작.
호음=좋은 소리.
호의불결=의심이 많아 결정을 제대로 하지 못한다
화기=몹시 노한 기운
화담=정답게 주고받는 말. 
화류=자단의 목재. 붉고 결이 고운데다 단단함.
화불단행=재앙은 혼자 오지 않음
화육법=동양화에서 그림을 그리는 여섯 가지 기법을 이르는 말.
화장=한복 저고리의 등솔에서 소매 끝까지의 거리
화장=배에서 밥 짓는 사람
화직=높고 화려한 벼슬자리
환자식=건강의 균형을 잃은 환자에게 주는 적당한 식사.
환절기=환형동물의 배설기관. 환절마다 한 쌍씩 있음.
환희=불교에서 불법을 듣고 신심을 얻음으로써 얻는 기쁨
활여=도량이 넓고 시원스러움
황송=나무를 벤 뒤 5,6년이 지나 땅속의 뿌리에 복령이 생기는 소나무
황조=세상을 떠난 자기 할아버지를 높이는 말
회답=물음에 대하여 대답함. 또는 그 대답.
회불사=불화를 그리는 사람
회선운동=식물이 다른 물건을 감고 올라가는 생장 운동의 한가지.
효칙=본받아 법으로 삼음.
훈증제=살충제의 하나. 유독 가스를 발생시켜 죽임. 
휴면=환경이나 조건이 생활에 부적당할 때 생물이 그 발육이나 활동을 일시적으로 거의 정지하는 상태로 되는 일. ㅇㅇ 상태에 들어가다.